################
#....~~~~~.....#
#....~~~~~.....#
#....#####.....#
#.@......#.....#
#........#.....#
################