################
#....~~~~~.....#
#....~~~~~.....#
#....#####.....#
#........#.....#
#........#.....#
################