################
#..............#
#..............#
#....#####.....#
#........#.....#
#........#.....#
################